S.##......
#.##P.###.
#.###.###.
#.....###.
###W#####S